אהב=אהבה
אושר=אשר
אכילה=אכל
ארץ=הארץ
ארץ~ישראל=ארץ~כנען
אלך<אֶפְעַל
אלכה<אֶפְעֲלָה
בגד=בגדים
בן~זקונים=ילד~זקונים
ברזל=הברזל
דבור=דבר
דבק>דבקת
דבק>הדביק
הגדה=הגיד=מגיד
הנשה=נשה
הצלחה=צלח
הקים=מקים
התפאר<פאר
הִתְרָאֶה<ראה
הִתְרָאֶה>תתראו
ז=שבעה
זקן=זקנים
חיב=חייב
חנה=מחנה
חרטום=חרטומים=חרטם=חרטמים
טבע=טבעיית
טמן=מטמון
טען>טענה
טענה>טענות
יאור=נילוס
יב=שנים~עשר=שתים~עשר
יג=שלוש~עשרה=שלשה~עשר
יוצא=יצא=יציאה=יציאת
לֵךְ<פְעַל
לְכָה<פָעֳלָה
לקח=מלקוח
מאת=מאתי
מוצא=מוצאות=מצא=מציאה
מושל=משל
מכירה=מכר
מנוחה=נח
משפט=שופט=שפט
מתנה=נתן
נס=נסיית
סְגוּלָה=סְגֻלָּה
ספור<סִפֵּר
עונש=ענש
עמוק=עמוקה
ערב>ערבות
ערבה=ערבת
פני=פנים
פרות=פרי
קורות=קרה
ראה=רואה
שָׁבָה=שבי
שח=שיח
שנא=שנאה
תנים=תנין
